8,1,1,1,5
6,1,1,1,4
9,1,1,1,5
7,2,1,1,6
6,2,1,1,5
6,3,1,1,5
5,3,1,1,5
8,4,1,1,6
9,4,1,1,6
9,5,1,1,5
7,5,1,1,6
5,5,1,1,5
