4,0,2,2,3
4,2,2,2,3
4,4,2,2,3
6,0,2,2,4
6,6,2,2,4
8,4,2,2,4
10,6,2,2,3
10,0,2,2,4
