3,4,1,1,4
4,3,1,1,4
5,3,1,1,4
7,3,1,1,4
10,3,1,1,4
11,3,1,1,4
4,4,1,1,4
5,4,1,1,5
7,4,1,1,5
8,4,1,1,4
9,4,1,1,5
13,4,1,1,4
4,5,1,1,3
6,5,1,1,4
8,5,1,1,3
10,5,1,1,4
11,5,1,1,5
12,5,1,1,4
13,5,1,1,4
