3,2,1,1,5
3,3,1,1,5
3,4,1,1,6
3,5,1,1,5
4,1,1,1,5
4,2,1,1,6
4,5,1,1,6
4,6,1,1,5
5,1,1,1,6
5,3,1,1,5
5,4,1,1,6
6,1,1,1,6
6,3,1,1,6
6,4,1,1,5
6,6,1,1,5
7,1,1,1,5
7,2,1,1,6
7,4,1,1,6
7,5,1,1,6
7,6,1,1,5
8,1,1,1,5
8,2,1,1,6
8,3,1,1,5
8,5,1,1,6
8,6,1,1,6
9,1,1,1,5
9,3,1,1,5
9,4,1,1,6
9,6,1,1,6
10,1,1,1,5
10,3,1,1,5
10,4,1,1,6
10,6,1,1,6
11,1,1,1,5
11,2,1,1,6
11,5,1,1,6
11,6,1,1,5
12,5,1,1,6
12,4,1,1,6
12,3,1,1,5
12,2,1,1,6
5,6,1,1,6
