5,3,1,1,4
5,5,1,1,4
6,1,1,1,3
6,2,1,1,4
6,3,1,1,4
7,2,1,1,5
7,5,1,1,5
8,1,1,1,4
9,1,1,1,4
8,4,1,1,5
9,4,1,1,5
9,5,1,1,4
