4,1,1,1,5
6,2,1,1,6
9,2,1,1,6
11,2,1,1,5
9,1,1,1,5
5,3,1,1,5
6,3,1,1,6
8,4,1,1,6
9,4,1,1,5
7,5,1,1,5
10,5,1,1,5
5,6,1,1,5
