4,1,1,1,4
6,2,1,1,5
9,2,1,1,5
11,2,1,1,4
9,1,1,1,4
5,3,1,1,4
6,3,1,1,5
8,4,1,1,5
9,4,1,1,4
7,5,1,1,4
10,5,1,1,4
5,6,1,1,4
