5,0,1,1,3
4,0,1,1,3
6,0,1,1,3
8,0,1,1,4
9,0,1,1,4
12,0,1,1,4
13,0,1,1,3
2,1,1,1,4
3,1,1,1,4
4,1,1,1,4
5,1,1,1,3
6,1,1,1,4
7,1,1,1,4
8,1,1,1,5
10,1,1,1,5
12,1,1,1,5
13,1,1,1,4
4,2,1,1,5
5,2,1,1,4
8,2,1,1,5
10,2,1,1,4
13,2,1,1,4
3,3,1,1,5
5,3,1,1,5
7,3,1,1,4
8,3,1,1,5
10,3,1,1,6
2,4,1,1,4
6,4,1,1,4
7,4,1,1,4
12,4,1,1,4
11,4,1,1,4
10,4,1,1,5
