4,3,1,1,4
5,1,1,1,2
8,1,1,1,3
9,1,1,1,3
5,2,1,1,4
7,2,1,1,4
8,2,1,1,4
6,3,1,1,5
8,3,1,1,4
9,3,1,1,4
6,4,1,1,4
7,4,1,1,5
8,4,1,1,4
9,4,1,1,4
6,5,1,1,3
7,5,1,1,3
8,5,1,1,4
9,5,1,1,3
