4,3,1,1,5
5,1,1,1,3
8,1,1,1,4
9,1,1,1,4
5,2,1,1,5
7,2,1,1,5
8,2,1,1,5
6,3,1,1,6
8,3,1,1,5
9,3,1,1,5
6,4,1,1,5
7,4,1,1,6
8,4,1,1,5
9,4,1,1,5
6,5,1,1,4
7,5,1,1,4
8,5,1,1,5
9,5,1,1,4
