4,0,2,2,4
6,0,2,2,4
8,0,2,2,4
4,2,2,2,5
6,2,2,2,5
8,2,2,2,5
10,2,2,2,3
8,4,2,2,6
4,6,2,2,4
6,6,2,2,5
10,6,2,2,4
