6,1,1,1,3
6,2,1,1,3
8,2,1,1,5
9,2,1,1,4
7,3,1,1,3
9,3,1,1,3
6,4,1,1,2
7,4,1,1,3
8,5,1,1,3
9,5,1,1,3
