9,1,1,1,4
3,3,1,1,4
4,1,1,1,4
5,2,1,1,5
5,3,1,1,5
5,4,1,1,5
4,5,1,1,4
6,6,1,1,5
8,6,1,1,4
7,4,1,1,5
7,2,1,1,5
8,4,1,1,4
9,5,1,1,5
9,3,1,1,4
11,2,1,1,4
10,5,1,1,4
6,0,1,1,4
5,6,1,1,5
