6,0,2,2,4
6,2,2,2,6
6,4,2,2,6
6,6,2,2,4
2,2,2,2,5
2,4,2,2,5
10,4,2,2,5
10,2,2,2,5
