3,2,1,1,4
3,3,1,1,4
3,4,1,1,5
3,5,1,1,4
4,1,1,1,4
4,2,1,1,5
4,5,1,1,5
4,6,1,1,4
5,1,1,1,5
5,3,1,1,4
5,4,1,1,5
6,1,1,1,5
6,3,1,1,5
6,4,1,1,4
6,6,1,1,4
7,1,1,1,4
7,2,1,1,5
7,4,1,1,5
7,5,1,1,5
7,6,1,1,4
8,1,1,1,4
8,2,1,1,5
8,3,1,1,4
8,5,1,1,5
8,6,1,1,5
9,1,1,1,4
9,3,1,1,4
9,4,1,1,5
9,6,1,1,5
10,1,1,1,4
10,3,1,1,4
10,4,1,1,5
10,6,1,1,5
11,1,1,1,4
11,2,1,1,5
11,5,1,1,5
11,6,1,1,4
12,5,1,1,5
12,4,1,1,5
12,3,1,1,4
12,2,1,1,5
5,6,1,1,5