2,2,1,1,3
3,2,1,1,3
3,6,1,1,3
4,2,1,1,4
4,5,1,1,3
5,2,1,1,3
5,1,1,1,3
5,3,1,1,4
5,4,1,1,3
5,5,1,1,4
6,2,1,1,3
6,3,1,1,4
7,1,1,1,3
7,3,1,1,4
7,4,1,1,4
7,5,1,1,4
7,6,1,1,3
8,6,1,1,4
8,4,1,1,4
8,2,1,1,4
9,2,1,1,2
9,4,1,1,3
9,5,1,1,5
9,6,1,1,5
10,2,1,1,3
10,4,1,1,3
10,6,1,1,3
11,2,1,1,3
11,3,1,1,3
11,6,1,1,3
12,2,1,1,3
12,5,1,1,3
13,2,1,1,3
13,3,1,1,3
13,4,1,1,4
7,2,1,1,4
