4,2,1,1,3
5,1,1,1,4
5,2,1,1,4
6,2,1,1,5
7,2,1,1,5
8,2,1,1,4
4,3,1,1,3
5,3,1,1,4
7,3,1,1,5
8,4,1,1,5
9,4,1,1,5
10,4,1,1,4
10,5,1,1,5
7,5,1,1,4
4,5,1,1,4
5,6,1,1,5
8,6,1,1,5
9,6,1,1,4
10,6,1,1,4
4,7,1,1,4
5,7,1,1,4
6,7,1,1,5
7,7,1,1,4
8,7,1,1,4
