8,0,1,1,4
10,0,1,1,4
7,0,1,1,3
8,1,1,1,5
7,2,1,1,4
8,2,1,1,5
9,2,1,1,5
9,3,1,1,5
10,3,1,1,4
7,4,1,1,4
9,4,1,1,5
7,5,1,1,4
8,5,1,1,5
9,5,1,1,6
9,6,1,1,5
