3,1,1,1,4
7,1,1,1,4
10,1,1,1,4
2,2,1,1,4
4,2,1,1,5
8,2,1,1,5
10,2,1,1,5
5,3,1,1,5
7,3,1,1,4
9,3,1,1,5
11,3,1,1,5
13,3,1,1,5
4,4,1,1,5
6,4,1,1,4
7,4,1,1,4
8,4,1,1,5
5,5,1,1,4
6,5,1,1,4
9,5,1,1,5
12,5,1,1,5
3,6,1,1,4
8,6,1,1,4
10,6,1,1,5
11,6,1,1,4
