4,2,1,1,3
5,0,1,1,4
6,0,1,1,4
9,0,1,1,4
11,0,1,1,4
7,1,1,1,5
8,1,1,1,3
11,1,1,1,4
6,2,1,1,4
7,2,1,1,4
9,2,1,1,4
10,2,1,1,4
7,3,1,1,3
8,3,1,1,4
4,4,1,1,3
5,4,1,1,4
6,4,1,1,4
8,4,1,1,4
11,4,1,1,4
4,5,1,1,3
5,5,1,1,4
7,5,1,1,5
8,5,1,1,5
9,5,1,1,6
10,5,1,1,5
11,5,1,1,4
5,6,1,1,3
7,6,1,1,4
8,6,1,1,4
10,6,1,1,3
11,6,1,1,3
