3,1,1,1,4
6,1,1,1,5
7,1,1,1,4
9,1,1,1,4
10,1,1,1,4
11,1,1,1,4
3,2,1,1,4
4,2,1,1,5
7,2,1,1,5
10,2,1,1,5
4,3,1,1,5
5,3,1,1,5
8,3,1,1,6
10,3,1,1,5
4,4,1,1,4
8,4,1,1,5
5,5,1,1,5
7,5,1,1,5
9,5,1,1,6
11,5,1,1,4
4,6,1,1,4
6,6,1,1,5
7,6,1,1,4
