10,4,2,2,6
0,6,2,2,5
2,2,2,2,5
4,4,2,2,6
6,2,2,2,6
8,0,2,2,6
8,6,2,2,5
14,4,2,2,5
12,2,2,2,6
