10,4,2,2,4
0,6,2,2,3
2,2,2,2,3
4,4,2,2,4
6,2,2,2,4
8,0,2,2,4
8,6,2,2,3
14,4,2,2,3
12,2,2,2,4
