0,0,2,2,4
2,4,2,2,6
4,2,2,2,6
4,6,2,2,4
6,4,2,2,6
8,0,2,2,4
8,2,2,2,5
8,4,2,2,6
8,6,2,2,5
12,2,2,2,5
12,6,2,2,5
14,4,2,2,4
14,0,2,2,4
