6,0,2,2,4
8,0,2,2,4
10,0,2,2,4
10,2,2,2,5
8,2,2,2,6
6,2,2,2,6
4,2,2,2,5
4,4,2,2,5
10,4,2,2,5
10,6,2,2,4
4,6,2,2,4
4,0,2,2,4
8,6,2,2,5
6,6,2,2,5
6,4,2,2,6
8,4,2,2,6
