3,2,1,1,4
2,3,1,1,4
4,2,1,1,4
5,2,1,1,4
7,2,1,1,3
8,2,1,1,3
10,2,1,1,3
12,2,1,1,4
3,3,1,1,5
4,3,1,1,5
6,3,1,1,3
9,3,1,1,4
11,3,1,1,5
12,3,1,1,4
2,4,1,1,5
3,4,1,1,5
4,4,1,1,6
5,4,1,1,4
7,4,1,1,4
8,4,1,1,4
9,4,1,1,4
10,4,1,1,5
2,5,1,1,4
3,5,1,1,4
5,5,1,1,4
6,5,1,1,5
7,5,1,1,5
8,5,1,1,5
9,5,1,1,4
11,5,1,1,5
12,5,1,1,5
13,5,1,1,5
2,6,1,1,3
5,6,1,1,4
7,6,1,1,5
9,6,1,1,4
11,6,1,1,5
13,6,1,1,4
