2,2,1,1,4
2,3,1,1,4
2,4,1,1,5
2,5,1,1,5
3,1,1,1,4
3,3,1,1,4
3,6,1,1,4
4,2,1,1,5
4,3,1,1,5
4,5,1,1,6
5,3,1,1,5
5,4,1,1,4
6,3,1,1,5
6,4,1,1,4
6,1,1,1,4
6,6,1,1,3
7,7,1,1,3
7,5,1,1,4
7,2,1,1,5
7,0,1,1,4
8,1,1,1,5
8,3,1,1,5
8,4,1,1,5
8,6,1,1,4
9,3,1,1,5
9,4,1,1,4
10,2,1,1,5
10,5,1,1,4
11,1,1,1,4
11,3,1,1,4
11,6,1,1,4
12,5,1,1,5
12,4,1,1,5
12,3,1,1,5
12,2,1,1,5
13,3,1,1,4
