6,2,2,2,6
4,2,2,2,5
4,4,2,2,5
6,4,2,2,6
8,2,2,2,5
10,2,2,2,6
8,4,2,2,5
10,4,2,2,6
4,6,2,2,5
6,6,2,2,6
8,6,2,2,5
10,6,2,2,6
