8,0,2,2,3
6,2,2,2,3
8,2,2,2,4
10,2,2,2,4
12,2,2,2,3
4,4,2,2,3
6,4,2,2,5
8,4,2,2,5
10,4,2,2,4
6,6,2,2,4
10,6,2,2,3
