2,4,2,2,4
4,2,2,2,5
4,0,2,2,3
6,2,2,2,4
6,6,2,2,4
8,6,2,2,3
8,4,2,2,5
8,0,2,2,3
10,0,2,2,3
