4,1,1,1,4
4,3,1,1,4
4,5,1,1,5
5,2,1,1,5
5,3,1,1,5
5,6,1,1,4
6,6,1,1,5
6,3,1,1,5
6,1,1,1,5
7,5,1,1,5
8,6,1,1,5
8,3,1,1,5
8,1,1,1,4
9,2,1,1,4
9,3,1,1,5
9,5,1,1,5
10,5,1,1,5
10,2,1,1,4
11,5,1,1,4
