6,1,1,1,3
8,1,1,1,4
10,1,1,1,3
6,2,1,1,4
7,2,1,1,5
8,2,1,1,6
10,2,1,1,4
6,3,1,1,4
7,3,1,1,5
9,3,1,1,5
10,3,1,1,4
9,4,1,1,6
9,5,1,1,5
8,5,1,1,4
6,5,1,1,3
