6,0,2,2,5
6,2,2,2,6
10,0,2,2,5
10,4,2,2,5
6,6,2,2,5
2,6,2,2,5
2,2,2,2,5
4,4,2,2,6
8,2,2,2,6
