4,1,1,1,1
5,2,1,1,3
3,3,1,1,2
5,5,1,1,3
4,6,1,1,2
3,5,1,1,2
7,3,1,1,3
6,4,1,1,2
9,2,1,1,2
10,1,1,1,1
8,4,1,1,3
9,5,1,1,3
10,6,1,1,2
11,5,1,1,2
11,3,1,1,2
