5,1,1,1,5
10,1,1,1,5
9,2,1,1,5
7,2,1,1,6
7,3,1,1,5
6,3,1,1,5
10,4,1,1,5
8,4,1,1,6
5,5,1,1,5
7,5,1,1,6
9,5,1,1,6
