0,0,2,2,4
2,0,2,2,5
4,2,2,2,6
2,4,2,2,4
6,4,2,2,5
6,0,2,2,5
8,2,2,2,5
10,4,2,2,6
14,4,2,2,4
12,6,2,2,3
14,6,2,2,3
8,6,2,2,4
