0,0,2,2,5
10,0,2,2,6
12,2,2,2,6
8,2,2,2,6
6,2,2,2,6
6,4,2,2,6
2,2,2,2,6
4,6,2,2,5
10,4,2,2,5
4,0,2,2,5
