7,2,1,1,5
8,2,1,1,5
7,3,1,1,5
8,3,1,1,6
9,3,1,1,4
7,4,1,1,4
8,4,1,1,5
9,4,1,1,4
7,5,1,1,3
8,5,1,1,4
