7,1,1,1,3
6,2,1,1,3
8,2,1,1,4
7,3,1,1,4
9,3,1,1,4
3,5,1,1,3
7,5,1,1,3
11,5,1,1,3
4,4,1,1,4
5,3,1,1,4
5,5,1,1,4
6,4,1,1,4
8,4,1,1,4
10,4,1,1,4
9,5,1,1,4
