7,1,1,1,5
6,2,1,1,5
8,2,1,1,6
5,3,1,1,5
7,3,1,1,6
9,3,1,1,6
4,4,1,1,5
6,4,1,1,5
8,4,1,1,5
10,4,1,1,5
3,5,1,1,5
5,5,1,1,5
7,5,1,1,5
9,5,1,1,5
11,5,1,1,5
