9,2,1,1,4
6,3,1,1,4
7,3,1,1,4
8,3,1,1,4
9,3,1,1,4
6,4,1,1,4
7,4,1,1,4
8,4,1,1,6
6,5,1,1,4
7,5,1,1,4
8,5,1,1,5
9,5,1,1,4
