2,0,1,1,3
3,0,1,1,3
4,0,1,1,4
5,0,1,1,4
6,0,1,1,3
7,0,1,1,4
8,0,1,1,4
9,0,1,1,4
11,0,1,1,4
12,0,1,1,4
2,1,1,1,3
5,1,1,1,4
11,1,1,1,4
10,1,1,1,5
2,2,1,1,4
4,2,1,1,5
9,2,1,1,4
10,2,1,1,4
11,2,1,1,4
2,3,1,1,4
4,3,1,1,4
8,3,1,1,4
12,3,1,1,4
2,4,1,1,3
4,4,1,1,4
7,4,1,1,5
12,4,1,1,5
2,5,1,1,3
4,5,1,1,5
6,5,1,1,5
7,5,1,1,4
11,5,1,1,4
2,6,1,1,3
4,6,1,1,4
5,6,1,1,3
6,6,1,1,5
10,6,1,1,3
2,7,1,1,3
3,7,1,1,4
4,7,1,1,4
6,7,1,1,4
7,7,1,1,4
8,7,1,1,4
9,7,1,1,3
9,3,1,1,3
