8,4,2,2,5
4,0,2,2,4
6,2,2,2,5
10,2,2,2,4
4,4,2,2,4
2,6,2,2,4
6,6,2,2,4
10,6,2,2,5
14,4,2,2,4
