8,4,2,2,6
4,0,2,2,5
6,2,2,2,6
10,2,2,2,5
4,4,2,2,5
2,6,2,2,5
6,6,2,2,5
10,6,2,2,6
14,4,2,2,5
