4,2,2,2,3
6,2,2,2,4
8,2,2,2,5
10,2,2,2,4
4,4,2,2,4
8,4,2,2,6
