3,1,1,1,3
5,1,1,1,3
8,1,1,1,4
9,1,1,1,5
10,1,1,1,5
11,1,1,1,4
12,1,1,1,3
2,2,1,1,4
5,2,1,1,4
8,2,1,1,5
10,2,1,1,5
2,3,1,1,4
3,3,1,1,5
4,3,1,1,5
6,3,1,1,4
7,3,1,1,4
8,3,1,1,4
10,3,1,1,4
11,3,1,1,4
2,4,1,1,3
5,4,1,1,3
8,4,1,1,3
9,4,1,1,4
10,4,1,1,4
3,5,1,1,4
5,5,1,1,4
6,5,1,1,4
10,5,1,1,4
2,6,1,1,4
3,6,1,1,5
4,6,1,1,5
5,6,1,1,6
9,6,1,1,4
10,6,1,1,5
11,6,1,1,5
12,6,1,1,4
2,7,1,1,3
3,7,1,1,4
4,7,1,1,4
7,7,1,1,4
9,7,1,1,4
10,7,1,1,4
12,7,1,1,3
